	tags
	array
凤凰新闻	新闻资讯
今日头条	新闻资讯
趣头条	新闻资讯
搜狐新闻	新闻资讯
腾讯新闻	新闻资讯
天天快报	新闻资讯
网易	新闻资讯
网易新闻	新闻资讯
新浪	新闻资讯
新浪新闻	新闻资讯
一点资讯	新闻资讯
字节跳动	新闻资讯
zaker	新闻资讯
吉比特	网络游戏
巨人网络	网络游戏
盛大游戏	网络游戏
腾讯	网络游戏
完美世界	网络游戏
蜗牛	网络游戏
西山居	网络游戏
掌趣	网络游戏
祖龙	网络游戏
香蕉计划	网络游戏
QG俱乐部	网络游戏
VSPN	网络游戏
NEOTV	网络游戏
天美工作室	网络游戏
百度贴吧	社交网络
抖音	社交网络
豆瓣	社交网络
飞信	社交网络
快手	社交网络
米聊	社交网络
陌陌	社交网络
派派	社交网络
探探	社交网络
腾讯	社交网络
微信	社交网络
新浪微博	社交网络
知乎	社交网络
momo	社交网络
QQ	社交网络
豆瓣网	社交网络
微博	社交网络
天涯社区	社交网络
百度	搜索
Google	搜索
WIKI	信息聚合
腾讯	即时通讯
56.0	影视音频
爱奇艺	影视音频
哔哩哔哩	影视音频
乐视	影视音频
搜狐	影视音频
搜狐视频	影视音频
腾讯视频	影视音频
土豆	影视音频
优酷	影视音频
bilibili	影视音频
pps	影视音频
pptv	影视音频
优酷土豆	影视音频
触手	直播
斗鱼	直播
虎牙	直播
花椒	直播
龙珠	直播
奇秀	直播
企鹅电竞	直播
熊猫	直播
秀色	直播
一直播	直播
映客	直播
战旗	直播
KK	直播
now直播	直播
YY	直播
秒拍	短视频行业
腾讯微视	短视频行业
西瓜视频	短视频行业
火山短视频	短视频行业
美拍	短视频行业
360.0	信息安全
奇虎	信息安全
绿盟云	信息安全
安全狗	信息安全
云子可信	信息安全
大白猿	信息安全
瑞星云	信息安全
码隆科技	机器视觉
pony.ai	机器视觉
旷视科技	机器视觉
商汤	机器视觉
依图	机器视觉
科大讯飞	语音识别
小水滴课堂	儿童早教
亿童	儿童早教
智慧树	儿童早教
创数教育	K12
大家汇教育	K12
大智教育	K12
德智教育	K12
凡学教育	K12
凤凰教育	K12
海风教育	K12
好未来	K12
黄冈中学网校	K12
继教网	K12
佳一教育	K12
家有学霸	K12
简单学习网	K12
菁优网	K12
考拉超课	K12
课后网	K12
跨学网	K12
快乐学	K12
乐乐课堂	K12
立思辰	K12
立思辰教育	K12
魔方格	K12
纳米盒	K12
清大教育	K12
全课网	K12
人教学习网	K12
睿智教育	K12
上海好学	K12
四季教育	K12
天学网	K12
微课网	K12
无忧课堂	K12
小猿搜题	K12
学霸君	K12
学而思	K12
学而思网校	K12
学科网	K12
洋葱数学	K12
赢鼎教育	K12
优学习	K12
猿辅导	K12
猿题库	K12
掌门1对1	K12
掌门一对一	K12
中科致知	K12
作业帮	K12
艾美迪	高等教育
比邻考研	高等教育
跨考考研	高等教育
万学教育	高等教育
文都教育	高等教育
学堂在线	高等教育
优课在线	高等教育
中国创业学院	高等教育
中国大学MOOC	高等教育
233网校	职业培训
51CTO学院	职业培训
5i课堂	职业培训
八戒教育	职业培训
北风网	职业培训
传智播客	职业培训
达内教育	职业培训
第九课堂	职业培训
多贝公开课	职业培训
高顿网校	职业培训
嗨学课堂	职业培训
恒企教育	职业培训
厚大法考	职业培训
华博教育	职业培训
华图教育	职业培训
环球网校	职业培训
极客学院	职业培训
开课吧	职业培训
考试吧	职业培训
考试通	职业培训
课工场	职业培训
路博教育	职业培训
慕课网	职业培训
奇迹曼特	职业培训
尚德机构	职业培训
尚德教育	职业培训
通铭教育	职业培训
文成教育	职业培训
我赢职场	职业培训
西普教育	职业培训
新华会计网	职业培训
邢帅教育	职业培训
兄弟连云课堂	职业培训
学尔森教育	职业培训
学易网校	职业培训
腰果公考	职业培训
英盛网	职业培训
英腾教育	职业培训
云学堂	职业培训
正保远程教育	职业培训
知途	职业培训
中大网校	职业培训
中国教师研修网	职业培训
中华会计网校	职业培训
中欧商业在线	职业培训
MOOC学院	职业培训
UniCareer	职业培训
环球教育	出国留学
极智批改网	出国留学
顺顺留学	出国留学
小马过河	出国留学
小马过河	出国留学
小站教育	出国留学
新航道	出国留学
新通教育	出国留学
有道精品课	出国留学
智课网	出国留学
51Talk无忧英语	语言学习
91外教网	语言学习
伯瑞英语	语言学习
驰声科技	语言学习
哒哒英语	语言学习
飞博教育	语言学习
汉普森英语	语言学习
好外教	语言学习
沪江网校	语言学习
考虫	语言学习
乐迪网	语言学习
米乐英语	语言学习
能动英语	语言学习
说客英语	语言学习
英语流利说	语言学习
ABC360	语言学习
VIPKID	语言学习
51talk	语言学习
萝卜网	语言学习
爱棋道	兴趣教育
博导前程	教育信息化
豆网家校宝	教育信息化
疯狂老师	教育信息化
光慧E课堂	教育信息化
孩教圈	教育信息化
恒峰信息	教育信息化
恒谦教育	教育信息化
互联天下	教育信息化
乐教乐学	教育信息化
联汛教育	教育信息化
能龙教育	教育信息化
朴新教育	教育信息化
全通教育	教育信息化
世纪天鸿	教育信息化
水晶球教育	教育信息化
四叶草社区	教育信息化
校宝在线	教育信息化
学邦教育	教育信息化
一起作业	教育信息化
一起作业网	教育信息化
志诚教育	教育信息化
智学网	教育信息化
作业盒子	教育信息化
华航唯实	教辅设备
巨龙科教	教辅设备
科明数码	教辅设备
前景云	教辅设备
天英教育	教辅设备
鑫日科	教辅设备
展视互动	教辅设备
百度传课	综合教育
跟谁学	综合教育
沪江网	综合教育
决胜网	综合教育
能力天空	综合教育
圣才电子书	综合教育
圣才教育	综合教育
淘宝教育	综合教育
腾讯课堂	综合教育
网易公开课	综合教育
网易云课堂	综合教育
新东方	综合教育
新东方教育在线	综合教育
新浪公开课	综合教育
中公教育	综合教育
中教未来	综合教育
YY教育	综合教育
拍拍贷	借贷
人人贷	借贷
宜信	借贷
平安普惠	借贷
阿里巴巴	支付
安邦保险	保险
安邦汽车保险	保险
安心保险	保险
保险岛	保险
保险极客	保险
保险师	保险
车险无忧	保险
车小保	保险
出口信用	保险
大地财产保险	保险
大地财险	保险
大地车辆保险	保险
大算车保	保险
大特保	保险
豆包网	保险
工银安盛	保险
光大永明	保险
国寿财险	保险
国寿股份	保险
国泰产险	保险
合金在线	保险
合众人寿	保险
和泰人寿	保险
华泰集团	保险
华夏人寿	保险
建信人寿	保险
京东保险	保险
君康人寿	保险
开心保	保险
里城保	保险
量子保	保险
美团保险	保险
民生人寿	保险
平安	保险
平安财险	保险
平安集团	保险
平安人寿	保险
平安养老	保险
前海人寿	保险
轻松e宝	保险
人保财险	保险
人保集团	保险
人保健康	保险
人保人寿	保险
人保寿险	保险
人寿集团	保险
生命人寿	保险
盛世大联	保险
四叶草车险	保险
太保财险	保险
太保人寿	保险
太平保险	保险
太平财产保险	保险
太平财险	保险
太平车辆保险	保险
太平车险	保险
太平集团	保险
太平人寿	保险
太平洋财险	保险
太平洋产险	保险
太平洋车辆保险	保险
太平洋集团	保险
太平洋人寿	保险
泰康人寿	保险
泰康人寿保险	保险
泰康在线	保险
天安保险	保险
天安财产保险	保险
天安财险	保险
天安车辆保险	保险
微保	保险
悟空保	保险
小保科技	保险
小米保险	保险
新华人寿	保险
新华人寿保险	保险
信诚人寿	保险
信美互助	保险
信美人寿	保险
信美相互	保险
幸福人寿	保险
阳光保险	保险
阳光财产保险股份有限公司	保险
阳光财险	保险
阳光车辆保险	保险
阳光集团	保险
阳光人寿	保险
一天车险	保险
易安保险	保险
意时网	保险
英大人寿	保险
永安保险	保险
永安车辆保险	保险
友邦人寿	保险
云嘀车保	保险
运动保	保险
支付宝健康服务	保险
中国财产再保险	保险
中国出口信用保险	保险
中国大地财产保险	保险
中国平安	保险
中国平安保险	保险
中国平安财产保险	保险
中国人保财险	保险
中国人民保险	保险
中国人民财产保险	保险
中国人民财产保险股份有限公司	保险
中国人民人寿保险	保险
中国人寿	保险
中国人寿保险	保险
中国人寿财产保险	保险
中国人寿再保险	保险
中国太平保险	保险
中国太平洋保险	保险
中国太平洋财产保险	保险
中华财险	保险
中华控股	保险
中华联合保险	保险
中华联合财产保险	保险
中华联合财险	保险
中华联合车辆保险	保险
中美联泰	保险
中意人寿	保险
中英人寿	保险
中邮人寿	保险
中再集团	保险
众安保险	保险
最惠保	保险
AB财险	保险
AB集团	保险
AB人寿	保险
OK车险	保险
PICCP&C	保险
平安财产保险	保险
中国人保财险	保险
太平洋保险	保险
泰康保险	保险
平安保险	保险
和谐健康	保险
安邦人寿	保险
百度金融	理财
京东金融	理财
理财通	理财
陆金所	理财
苏宁金融	理财
万达金融	理财
网易理财	理财
余额宝	理财
支付宝	理财
博时基金	理财
安信基金	理财
易方达基金	理财
南方基金	理财
富国基金	理财
国泰基金	理财
汇添富基金	理财
广发基金	理财
华安基金	理财
华夏基金	理财
布比区块链	虚拟货币
唐盛链	虚拟货币
火币	虚拟货币
银链科技	虚拟货币
区块元	虚拟货币
邻萌宝	虚拟货币
BTCC	虚拟货币
巴比特	虚拟货币
OnChain	虚拟货币
OKCoin	虚拟货币
神州融	信用及征信
中泰信托	信用及征信
四川信托	信用及征信
民生信托	信用及征信
中江信托	信用及征信
中信信托	信用及征信
光大信托	信用及征信
中融信托	信用及征信
吉林信托	信用及征信
达晨创投	投融资
红杉资本	投融资
江苏高科技投资	投融资
经纬创投	投融资
君联资本	投融资
启明创投	投融资
赛富	投融资
上海永宣创业投资	投融资
深创投	投融资
毅达资本	投融资
中国风险投资	投融资
dcm资本	投融资
idg资本	投融资
英特尔投资	投融资
软银中国创业投资有限公司	投融资
祥峰中国投资公司	投融资
凯雷投资集团	投融资
北京软银赛富投资顾问有限公司	投融资
中科招商创业投资管理有限公司	投融资
德丰杰-龙脉中国基金	投融资
创新工场	投融资
联想投资有限公司	投融资
兰馨亚洲投资集团	投融资
上海华盈创业投资基金管理有限公司	投融资
渣打银行（香港）有限公司	投融资
红杉资本中国基金	投融资
普凯投资基金（Prax Capital）	投融资
卓凡创业投资公司（Jovan Ventures	投融资
清华科技园创业投资有限公司	投融资
晨兴科技投资公司	投融资
百奥维达（上海）投资咨询有限公司	投融资
智基创投股份有限公司	投融资
IDG技术创业投资基金	投融资
深圳市创新投资集团有限公司	投融资
德同中国投资基金（DT Capital Partners）	投融资
成为基金	投融资
富达国际创业投资有限公司	投融资
华平创业投资有限公司	投融资
江苏高科技投资集团	投融资
盈富泰克创业投资公司	投融资
集富创业投资（香港）有限公司	投融资
华登太平洋创业投资管理有限公司	投融资
美国梧桐投资公司	投融资
美国中经合集团	投融资
高盛亚洲	投融资
上海联创投资管理有限公司	投融资
安永	财务税务
毕马威	财务税务
德勤	财务税务
普华永道	财务税务
德勤会计师事务所	财务税务
天职国际会计师事务所	财务税务
信永中和会计师事务所	财务税务
安永会计师事务所	财务税务
致同会计师事务所	财务税务
毕马威会计师事务所	财务税务
天健会计师事务所	财务税务
立信会计师事务所	财务税务
瑞华会计师事务所	财务税务
天健	财务税务
天职国际	财务税务
大华会计师事务所	财务税务
立信	财务税务
信永中和	财务税务
瑞华	财务税务
中信银行	银行
财务税务	银行
汇丰银行	银行
建设银行	银行
招商银行	银行
花旗银行	银行
汇丰银行	银行
中国银行	银行
平安银行	银行
农业银行	银行
摩拜	交通出行
滴滴	交通出行
罗思韦尔电气	车联网及硬件
齐家网	装修装潢
家居就	装修装潢
土巴兔	装修装潢
奥园	商业房产
保利	商业房产
碧桂园	商业房产
滨江	商业房产
海外	商业房产
恒大	商业房产
华夏幸福	商业房产
佳兆业	商业房产
金地	商业房产
金科	商业房产
金茂	商业房产
蓝光	商业房产
龙光	商业房产
龙湖	商业房产
绿城中国	商业房产
绿地	商业房产
荣盛	商业房产
融创中国	商业房产
融信	商业房产
世茂	商业房产
泰禾	商业房产
万科	商业房产
新城	商业房产
旭辉	商业房产
雅居乐	商业房产
阳光城	商业房产
正荣	商业房产
中国海外集团	商业房产
中梁	商业房产
中南	商业房产
华润置地	商业房产
恒大地产	商业房产
保利发展	商业房产
融创	商业房产
中海地产	商业房产
绿地地产	商业房产
博文房地产评估造价集团有限公司	土地估价
深圳市国策房地产土地估价有限公司	土地估价
深圳市戴德梁行土地房地产评估有限公司	土地估价
深圳市鹏信资产评估土地房地产估价有限公司	土地估价
中证房地产评估造价集团有限公司	土地估价
深圳市世联土地房地产评估有限公司	土地估价
北京仁达房地产评估有限公司	土地估价
深圳市同致诚土地房地产估价顾问有限公司	土地估价
安诺优达	生物技术
百迈客	生物技术
贝瑞和康	生物技术
博奥生物	生物技术
达安基因	生物技术
鼎晶生物	生物技术
凡迪生物	生物技术
泛生子	生物技术
海普洛斯	生物技术
瀚海基因	生物技术
华大基因	生物技术
华因康基因	生物技术
吉凯基因	生物技术
吉因加	生物技术
金唯智	生物技术
金域检验	生物技术
鹍远基因	生物技术
乐土精准医疗	生物技术
美吉生物	生物技术
美因基因	生物技术
明码生物	生物技术
诺禾致源	生物技术
燃石医学	生物技术
世和基因	生物技术
首度基因	生物技术
思路迪	生物技术
拓普基因	生物技术
碳云智能	生物技术
天昊基因	生物技术
希望组	生物技术
鑫诺美迪	生物技术
壹基因	生物技术
奕真生物	生物技术
裕策生物	生物技术
云健康	生物技术
中源协和	生物技术
39健康网	健康保健
阿里健康	健康保健
春雨医生	健康保健
丁香园	健康保健
好大夫在线	健康保健
健康之路	健康保健
平安好医生	健康保健
微医	健康保健
上海医药集团	健康保健
麦克森	健康保健
就医网	健康保健
CVS Health	健康保健
趣医网	健康保健
平安医疗	健康保健
3M	医疗器械及硬件
爱德华	医疗器械及硬件
爱德华生命科学	医疗器械及硬件
爱尔康	医疗器械及硬件
爱克发医疗	医疗器械及硬件
安络杰	医疗器械及硬件
奥林巴斯	医疗器械及硬件
奥林巴斯医疗	医疗器械及硬件
巴德	医疗器械及硬件
百特	医疗器械及硬件
百特国际	医疗器械及硬件
贝朗	医疗器械及硬件
贝朗医疗	医疗器械及硬件
碧迪	医疗器械及硬件
滨松	医疗器械及硬件
波士顿科学	医疗器械及硬件
蔡司医疗技术	医疗器械及硬件
丹纳赫	医疗器械及硬件
岛津	医疗器械及硬件
德尔格	医疗器械及硬件
德康医疗	医疗器械及硬件
登士柏	医疗器械及硬件
飞利浦	医疗器械及硬件
飞利浦医疗	医疗器械及硬件
费森尤斯	医疗器械及硬件
费森尤斯医疗	医疗器械及硬件
福田电子	医疗器械及硬件
富士	医疗器械及硬件
富士影像	医疗器械及硬件
豪洛捷	医疗器械及硬件
豪雅	医疗器械及硬件
洁定	医疗器械及硬件
捷迈邦美	医疗器械及硬件
康德乐	医疗器械及硬件
康乐保	医疗器械及硬件
康维德	医疗器械及硬件
柯尼卡美能达	医疗器械及硬件
科利耳	医疗器械及硬件
堀场	医疗器械及硬件
库珀医疗	医疗器械及硬件
罗氏诊断	医疗器械及硬件
迈心诺	医疗器械及硬件
美艾利尔	医疗器械及硬件
美敦力	医疗器械及硬件
美国精技	医疗器械及硬件
纳图斯医疗	医疗器械及硬件
欧麦斯-麦能	医疗器械及硬件
强生	医疗器械及硬件
日本广电	医疗器械及硬件
锐柯医疗	医疗器械及硬件
瑞思迈	医疗器械及硬件
赛默飞世尔	医疗器械及硬件
赛诺秀	医疗器械及硬件
山大华特	医疗器械及硬件
生物梅里埃	医疗器械及硬件
圣犹达医疗	医疗器械及硬件
施乐辉	医疗器械及硬件
史密斯	医疗器械及硬件
史密斯医疗	医疗器械及硬件
史塞克	医疗器械及硬件
史赛克	医疗器械及硬件
士卓曼	医疗器械及硬件
泰尔茂	医疗器械及硬件
泰利福医疗	医疗器械及硬件
瓦里安	医疗器械及硬件
瓦里安医疗系统	医疗器械及硬件
西门子医疗	医疗器械及硬件
雅培	医疗器械及硬件
医科达	医疗器械及硬件
依视路	医疗器械及硬件
英维康	医疗器械及硬件
远藤制药	医疗器械及硬件
Abiomed	医疗器械及硬件
Accuray	医疗器械及硬件
Align Technology	医疗器械及硬件
Alphatec	医疗器械及硬件
AngioDynamics	医疗器械及硬件
BD医疗	医疗器械及硬件
Bio-Rad	医疗器械及硬件
Cantel Medical	医疗器械及硬件
Cardiovascular Systems	医疗器械及硬件
Cepheid	医疗器械及硬件
CONMED	医疗器械及硬件
Consort Medical	医疗器械及硬件
Diasorin	医疗器械及硬件
DJO	医疗器械及硬件
Endologix	医疗器械及硬件
GE医疗	医疗器械及硬件
Getinge Group	医疗器械及硬件
Globus Medical	医疗器械及硬件
Greatbatch	医疗器械及硬件
Grifols	医疗器械及硬件
Guerbet	医疗器械及硬件
Heartware	医疗器械及硬件
ICU医疗	医疗器械及硬件
Immucor	医疗器械及硬件
Integra LifeSciences	医疗器械及硬件
Intuitive Surgical	医疗器械及硬件
LivaNova	医疗器械及硬件
Luminex	医疗器械及硬件
Meridian Bioscience	医疗器械及硬件
Merit Medical Systems	医疗器械及硬件
Miraca	医疗器械及硬件
Myriad Genetics	医疗器械及硬件
NuVasive	医疗器械及硬件
NxStage Medical	医疗器械及硬件
Orthofix International	医疗器械及硬件
Qiagen	医疗器械及硬件
Quidel	医疗器械及硬件
RTI Surgical	医疗器械及硬件
Sectra	医疗器械及硬件
Spectranetics	医疗器械及硬件
Stratec Biomedical Systems	医疗器械及硬件
Wright Medical Group	医疗器械及硬件
Ypsomed	医疗器械及硬件
艾伯维	制药
安进	制药
步长制药	制药
辅仁药业	制药
葛兰素史克	制药
广州医药	制药
哈药	制药
汉森制药	制药
华北制药	制药
华润三九医药	制药
华润双鹤	制药
辉瑞	制药
吉利德科学	制药
济川药业	制药
健民集团	制药
江苏豪森药业	制药
江苏恒瑞医药	制药
江西济民可信	制药
康美药业	制药
康芝药业	制药
葵花药业	制药
罗氏	制药
默沙东	制药
诺华	制药
齐鲁制药	制药
赛诺菲	制药
上海复星医药	制药
上海医药	制药
石药	制药
太极	制药
天津市医药	制药
天士力	制药
修正药业	制药
亚宝药业	制药
云南白药股	制药
正大天晴	制药
四川科伦药业股份有限公司	制药
四川科创医药集团有限公司	制药
上海复星医药(集团)股份有限公司	制药
云南白药集团股份有限公司	制药
辉瑞制药有限公司	制药
哈药集团股份有限公司	制药
江西济民可信集团有限公司	制药
扬子江药业集团	制药
康美药业股份有限公司	制药
修正药业集团股份有限公司	制药
CFDA	政府机构
FDA	政府机构
ICH	政府机构
WHO	政府机构
饿了么	美食餐饮
百度糯米	休闲娱乐
大麦网	休闲娱乐
美丽联合	休闲娱乐
新美大	休闲娱乐
永乐票务	休闲娱乐
沃尔玛	商场超市
小e微店	新零售
便利蜂	新零售
腾迈	传统广告
恒美	传统广告
阳狮广告	传统广告
4a	传统广告
奥美	传统广告
墨迹天气硬件部门	智能家居
极米	智能家居
空气检测	智能家居
无屏电视/智能投影	智能家居
空气果	智能家居
土曼	智能家居
智能手表	智能家居
蚁视科技	智能家居
智能钢琴	智能家居
壹台钢琴	智能家居
虚拟现实头盔	智能家居
High Fidelity	智能家居
戴尔	消费电子
海尔	消费电子
柯达	消费电子
联想	消费电子
美满科技	消费电子
普联技术	消费电子
三洋电机中国	消费电子
神州数码	消费电子
索尼	消费电子
CVT电子	消费电子
Dell	消费电子
kodak	消费电子
SONY	消费电子
TP-LINK	消费电子
德州仪器	芯片半导体
豪威半导体	芯片半导体
华大电子	芯片半导体
联发科	芯片半导体
美国模拟器件	芯片半导体
英特尔	芯片半导体
ADI	芯片半导体
Intel	芯片半导体
MTK	芯片半导体
TI	芯片半导体
比特大陆	芯片半导体
中电34所	仪器仪表
瑞典ENEA	嵌入式
周立功单片机	嵌入式
北京华虹	集成电路
成都国腾实业	集成电路
展讯通信	集成电路
云之家	办公OA
铂金	人力资源
雇得易	人力资源
汇通	人力资源
明源	人力资源
万古	人力资源
网龙	人力资源
智思	人力资源
中人网	人力资源
moka	人力资源
华信惠悦	人力资源
光辉国际	人力资源
FESCO	人力资源
上海外服	人力资源
任仕达	人力资源
米高蒲志	人力资源
韬睿	人力资源
万宝盛华	人力资源
KellyServices	人力资源
中智	人力资源
科锐	人力资源
君合	法律服务
方达	法律服务
海问	法律服务
观韬中茂	法律服务
竞天公诚	法律服务
金杜	法律服务
国浩	法律服务
中伦	法律服务
君泽君	法律服务
天元	法律服务
锦天城	法律服务
汉坤	法律服务
金诚同达	法律服务
北京品源知识产权代理有限公司	法律服务
隆天知识产权代理有限公司	法律服务
北京集佳知识产权代理有限公司	法律服务
中国专利代理（香港）有限公司	法律服务
中国国际贸易促进委员会专利商标事务所	法律服务
北京康信知识产权代理有限公司	法律服务
北京细软智谷知识产权代理有限公司	法律服务
广州华进联合专利商标代理有限公	法律服务
北京市柳沈律师事务所	法律服务
北京三友知识产权代理有限公司	法律服务
汉得信息	行业信息化及解决方案
华平信息	行业信息化及解决方案
有赞	行业信息化及解决方案
威胜	行业信息化及解决方案
oracle	数据服务
埃森哲	商业咨询
奥美公关国际	商业咨询
北大纵横	商业咨询
北京和君	商业咨询
贝恩	商业咨询
毕博	商业咨询
波士顿	商业咨询
博思智联	商业咨询
博斯	商业咨询
盖洛普	商业咨询
翰威特	商业咨询
惠普	商业咨询
基业昶青	商业咨询
久略	商业咨询
凯捷	商业咨询
凯捷安永	商业咨询
科尔尼	商业咨询
罗兰.贝格	商业咨询
罗兰贝格	商业咨询
麦肯锡	商业咨询
美世	商业咨询
锡恩	商业咨询
新华信	商业咨询
正略钧策	商业咨询
智越	商业咨询
德科（Adecco）	商业咨询
每日优鲜	生鲜食品
天天果园	生鲜食品
易果生鲜	生鲜食品
果小美	生鲜食品
猩便利	生鲜食品
哈米	生鲜食品
京东到家	生鲜食品
番茄	生鲜食品
百果园	生鲜食品
盒马鲜生	生鲜食品
领蛙	生鲜食品
小闪	生鲜食品
七只考拉	生鲜食品
易果	生鲜食品
达令APP	跨境电商
环球资源网	跨境电商
美淘村	跨境电商
网易考拉海淘	跨境电商
海淘	跨境电商
网易考拉	跨境电商
京东全球购	跨境电商
天猫全球购	跨境电商
欧美淘	跨境电商
囯际妈咪	跨境电商
苹果中国	奢侈品
Burberry	奢侈品
Prada	奢侈品
Dior	奢侈品
LVMH	奢侈品
Chanel	奢侈品
韩都衣舍官网	服装服饰
乐蜂网	化妆品
天天网	化妆品
贝贝网	母婴玩具
辣妈商城	母婴玩具
乐友孕婴童网上商城	母婴玩具
母婴之家	母婴玩具
美囤妈妈	母婴玩具
囯际妈咪	母婴玩具
宝贝衣橱	母婴玩具
蜜芽宝贝	母婴玩具
红孩子	母婴玩具
乐友	母婴玩具
美乐乐	家居家纺
尚品宅配	家居家纺
欧浦家具网	家居家纺
林氏木业	家居家纺
曲美家居	家居家纺
金海马	家居家纺
当当网	图书
孔夫子旧书网	图书
中国图书网	图书
金银岛	大宗商品
欧浦钢网	大宗商品
找钢网	大宗商品
找塑料网	大宗商品
1药网	医药
药房网	医药
1号店	生活用品
本来生活网	生活用品
敦煌网	生活用品
凡客诚品	生活用品
返利网	生活用品
钢银电商	生活用品
格瓦拉生活网	生活用品
广西糖网	生活用品
国联资源网	生活用品
国美在线	生活用品
好乐买	生活用品
慧聪网	生活用品
酒仙网	生活用品
聚美优品	生活用品
卷皮	生活用品
科通芯城	生活用品
口袋购物	生活用品
快塑网	生活用品
拉手网	生活用品
乐村淘	生活用品
链尚网	生活用品
马可波罗网	生活用品
麦包包	生活用品
麦考林	生活用品
麦乐购	生活用品
美菜网	生活用品
美丽说	生活用品
梦芭莎	生活用品
蜜芽	生活用品
名鞋库	生活用品
摩贝网	生活用品
蘑菇街	生活用品
拍鞋网	生活用品
趣玩网	生活用品
上品折扣	生活用品
生意宝	生活用品
时尚起义	生活用品
世界工厂网	生活用品
顺丰优选	生活用品
苏宁易购	生活用品
淘宝	生活用品
天猫	生活用品
沱沱工社	生活用品
万表网	生活用品
网易严选	生活用品
唯品会	生活用品
窝窝团	生活用品
我的钢铁网	生活用品
小红书	生活用品
新蛋网	生活用品
新居网	生活用品
阳光印网	生活用品
洋码头	生活用品
一呼百应	生活用品
易酒批	生活用品
银泰网	生活用品
优购网	生活用品
优信拍	生活用品
曰曰顺商城	生活用品
折海尔商城	生活用品
蜘蛛网	生活用品
中国供应商	生活用品
中国制造网	生活用品
中粮我买网	生活用品
走秀网	生活用品
钻石小鸟	生活用品
YOHO有货	生活用品
车易拍	二手交易
阿里巴巴	综合电商
京东	综合电商
苏宁	综合电商
亚马逊	综合电商
拼多多	综合电商
微软	系统工具
安得物流	货运物流
安吉物流	货运物流
安能聚创	货运物流
八达物流	货运物流
八方物流	货运物流
百世	货运物流
北京福田智科物流	货运物流
北京京粮物流	货运物流
渤海轮渡	货运物流
菜鸟网络	货运物流
沧州运输	货运物流
重庆港务物流	货运物流
达达配送	货运物流
达升物流	货运物流
德邦	货运物流
德邦物流	货运物流
点我达网络	货运物流
东方海外物流	货运物流
飞力达国际物流	货运物流
飞马国际供应链	货运物流
港中旅华贸国际物流	货运物流
贵阳货车帮	货运物流
哈密广汇物流	货运物流
海南海峡航运	货运物流
河北省物流产业	货运物流
河南鲜易供应链	货运物流
恒基达鑫国际	货运物流
恒通物流	货运物流
宏捷物流	货运物流
湖南一力	货运物流
华瑞物流	货运物流
华晓医药物流	货运物流
冀中能源国际物流	货运物流
佳吉快运	货运物流
嘉里大通物流	货运物流
建发物流	货运物流
江汽物流	货运物流
交运日红国际物流	货运物流
今天国际物流技术	货运物流
金陵交运	货运物流
锦程国际物流集团	货运物流
锦海捷亚国际货运	货运物流
京博物流	货运物流
京东物流	货运物流
林森物流	货运物流
领鲜物流	货运物流
漯河双汇物流投资	货运物流
蚂蚁物流	货运物流
美设国际货运	货运物流
宁波海运	货运物流
青岛日日顺物流	货运物流
青旅国际货运	货运物流
人人快送	货运物流
荣庆物流	货运物流
森华物流	货运物流
厦门国贸泰达物流	货运物流
山汉国际物流	货运物流
上港集团物流	货运物流
上海交运	货运物流
申通	货运物流
申通快递	货运物流
深圳市华鹏飞现代物流	货运物流
深圳市普路通供应链管理	货运物流
深圳正佳物流	货运物流
盛丰物流	货运物流
盛辉物流	货运物流
顺丰	货运物流
四川长虹民生物流	货运物流
苏宁物流	货运物流
苏汽国际物流	货运物流
天地汇供应链管理	货运物流
天津德利得供应链管理	货运物流
天津港物流发展	货运物流
天津五八到家生活服务	货运物流
万集物流	货运物流
萬林现代物流	货运物流
唯凯国际物流	货运物流
希杰荣庆物流供应链	货运物流
象屿速传供应链发展	货运物流
新杰物流	货运物流
新宁现代物流	货运物流
新武安钢铁集团	货运物流
许昌众荣冷链物流	货运物流
圆通	货运物流
圆通速递	货运物流
远成物流	货运物流
运满满	货运物流
韵达	货运物流
韵达控股	货运物流
长安民生物流	货运物流
长久物流	货运物流
招商局能源运输	货运物流
浙江百世物流	货运物流
振华物流	货运物流
正本物流	货运物流
郑明现代物流	货运物流
郑州交通运输集团有限责任公司	货运物流
中创物流	货运物流
中国厦门外轮代理	货运物流
中国石油天然气运输公司	货运物流
中国新兴交通物流	货运物流
中铁铁龙集装箱物流	货运物流
中通	货运物流
中通快递	货运物流
中外运	货运物流
中远海运物流	货运物流
三菱	汽车制造业
施耐德	汽车制造业
艾默生电气	通用设备制造业
爱默生电气	通用设备制造业
欧姆龙	通用设备制造业
通用电气	通用设备制造业
西门子	通用设备制造业
ABB	通用设备制造业
GE	通用设备制造业
三一重机	工程机械制造业
爱氏晨曦	食品
巴西食品	食品
邦吉	食品
保乐力加	食品
达利食品	食品
达能	食品
海天味业	食品
荷美尔食品	食品
华润	食品
皇家菲仕兰	食品
家乐氏	食品
金宝汤	食品
卡夫亨氏	食品
康尼格拉	食品
康师傅	食品
雀巢	食品
日本火腿	食品
三得利	食品
山崎面包	食品
上海梅林	食品
泰森食品	食品
通用磨坊	食品
统一	食品
万州国际	食品
万洲国际	食品
旺旺	食品
亿滋	食品
中国粮油	食品
中国食品	食品
ADM	食品
JBS	食品
尚品宅配	家具
欧浦家具网	家具
林氏木业	家具
曲美家居	家具
红星美凯龙	家具
HAY	家具
H&M	服装首饰
爱生雅	日化
宝洁	日化
高露洁	日化
高露洁棕榄	日化
汉高	日化
恒安国际	日化
花王	日化
立白	日化
利洁时	日化
联合利华	日化
欧莱雅	日化
维达	日化
雅诗兰黛	日化
百事	饮料
可口可乐	饮料
蒙牛	饮料
蒙牛股份	饮料
新希望	饮料
伊利	饮料
伊利股份	饮料
安徽中烟工业	烟草
奥驰亚	烟草
川渝中烟工业	烟草
帝国烟草	烟草
菲莫国际	烟草
红塔烟草	烟草
红云红河烟草	烟草
湖北中烟工业	烟草
湖南中烟工业	烟草
雷诺兹美国	烟草
日本烟草	烟草
上海烟草集团	烟草
上烟	烟草
英美烟草	烟草
浙江中烟工业	烟草
中烟	烟草
百威英博	酒
宾堡	酒
朝日	酒
帝亚吉欧	酒
贵州茅台	酒
华润啤酒	酒
嘉士伯	酒
金佰利	酒
路威酩轩	酒
南非米勒	酒
麒麟	酒
青岛啤酒	酒
五粮液	酒
喜力	酒
洋河股份	酒
北京移动	运营商
广东电信	运营商
广东联通	运营商
广东移动	运营商
上海电信	运营商
上海联通	运营商
上海移动	运营商
深圳电信	运营商
深圳联通	运营商
深圳移动	运营商
中国电信	运营商
中国联通	运营商
中国移动	运营商
爱立信	设备制造
高通	设备制造
华三	设备制造
中兴	设备制造
IBM	设备制造
上海贝尔阿尔卡特朗讯	设备制造
华为	终端制造
魅族	终端制造
摩托罗拉	终端制造
三星	终端制造
小米	终端制造
Motorola	终端制造
oppo	终端制造
vivo	终端制造
HTC	终端制造
宝利通	视频通信
飞视美	视频通信
海康威视	视频通信
好视通	视频通信
华望	视频通信
科达	视频通信
全时	视频通信
瑞视恒通	视频通信
声网	视频通信
思科系统	视频通信
小鱼易联	视频通信
亿联网络	视频通信
云之讯	视频通信
浙江大华	视频通信
Accano	视频通信
Agora	视频通信
Cisco	视频通信
facemeeting	视频通信
kedacom	视频通信
Polycom	视频通信
Vidyo	视频通信
zoom	视频通信
中国航天科技	军用航天
阿里巴巴	互联网
滴滴	互联网
饿了么	互联网
美团	互联网
摩拜	互联网
携程	电子商务
去哪儿网	电子商务
携程	旅游
去哪儿网	旅游